222222222222222222222
211111111111111111112
210000000010000000012
21S101101010101101S12
210100001000100001012
210110101010101011012
210000100000001000012
211011101111101110112
211000122222221000112
111010121121121010111
222210021222120012222
111000121111121000111
211110122222221011112
211000111010111000112
211010000010000010112
211011101010101110112
2100000000P0000000012
210110101111101011012
210100100000001001012
21S101111010111101S12
210000000010000000012
211111111111111111112
222222222222222222222