222222222222222222222
211111111111111111112
210000000010000000012
210110111010111011012
210000000000000000012
210110101111101011012
210000100010001000012
211110111010111011112
222210100000001012222
111110101121101011111
000000001222100000000
111110101111101011111
222210100000001012222
211110101111101011112
210000000010000000012
210110111010111011012
2100100000P0000010012
211010101111101010112
210000100010001000012
210111111010111111012
210000000000000000012
211111111111111111112
222222222222222222222