222222222222222222222
211111111111111111112
210000001000100000012
21S111101010101111S12
210100000010000001012
210001011010110100012
111101000000000101111
222201101111101102222
110000022222220000011
210110121121121011012
210000121222121000012
210101121111121101012
210100022222220001012
210110111010111011012
210000100010001000012
211010101111101010112
21S0100000P0000010S12
210110111010111011012
210000100010001000012
210110101111101011012
210000100000001000012
211111111111111111112
222222222222222222222