1111111110111111111
1P00000010000000001
1011101110111011101
1000100000000000001
1010101111101010101
1000101000001000101
1011101011101011101
1000000000000000001
1111111000001111111
0000000001000000000
1111111000001111111
1000000000000000001
1011101011101011101
1000101000001000101
1010101111101010101
1000100000000000001
1011101110111011101
1P00000010000000001
1111111110111111111