222222222222222222222
211111111111111111112
210000000010000000012
21S110111010111011S12
210000000000000000012
210110101111101011012
210000100010001000012
211110111212111011112
222210122222221012222
111110121121121011111
222220221222122022222
111110121111121011111
222210122222221012222
211110121111121011112
210000000010000000012
210110111010111011012
21S0100000P0000010S12
211010101111101010112
210000100010001000012
210111111010111111012
210000000000000000012
211111111111111111112
222222222222222222222