11111111111111111111
1P000000000000000001
10111101111101111001
00000100010001000000
10110111111110110101
10000000000000000001
11111111111111111111