11111111111111111111
10000000000000000001
10111101111101111001
10000100010001000001
10110111111110110101
10000000000000000001
11111111111111111111