222222222222222222222
211111111111111111112
210000001000100000012
21S111101010101111S12
210100000010000001012
210001011010110100012
111101000000000101111
220001121111121100022
110122222222222221011
210112121121121211012
210222121222121222012
210121121111121121012
210122222222222221012
210112111212111211012
210000100010001000012
211010101111101010112
21S0100000P0000010S12
210110111010111011012
210000100010001000012
210110101111101011012
210000100000001000012
211111111111111111112
222222222222222222222